W;W;W;W;W;W;W;W;W;W;W;W;W
W;G;G;G;G;G;G;G;W;G;W;G;G
W;G;G;G;G;G;G;G;W;G;P;G;G
W;G;G;G;G;G;G;G;S;G;P;G;G
W;G;G;G;G;G;G;G;W;G;P;S;W
W;G;G;G;G;G;G;G;W;G;G;G;W
W;G;G;G;G;G;G;G;W;G;G;G;W
W;G;G;G;G;G;G;G;W;G;G;G;W
W;G;G;G;G;G;G;G;W;G;G;G;W
W;G;G;G;G;G;G;G;W;G;G;G;W
W;G;G;G;G;G;G;G;W;G;G;G;W
W;G;G;G;G;G;G;G;W;G;G;G;W
W;G;G;G;G;G;G;G;W;G;G;G;W
W;G;G;G;G;G;G;G;W;G;G;G;W
W;G;G;G;G;G;G;G;P;G;G;G;W
W;G;G;G;G;G;G;G;P;G;G;G;W
W;G;G;G;G;G;G;G;P;G;G;G;W
W;W;W;W;W;W;W;W;W;W;W;W;W
